11111111111
1P0C0001
10000100001
10001010C01
1C01001001
10001010001
100001000E1
100000001
11111111111