11011111111
1P0C0000001
10000100001
10001010C00
1C010001001
10001010001
000001000E1
10000000001
11111111110