111111111111111111111111111111111111111
11111101000000000C1P1C00000000010111111
100000000110101101101101101011000010001
1C1000101C0010000000000000100C1010001C1
110011111111111111101111111111111110011
1001000100011100010C0100011100010001001
110001000100100100101001001001000100011
11111111111000111C0E0C11100011111111111
111111111111111111111111111111111111111